2 4 2 4 5 3 3 2 3 4 
5 0 3 3 3 2 4 5 0 3
0 3 1 5 0 5 0 1 2 0
2 3 4 5 4 0 2 5 3 2
3 0 1 2 0 5 0 1 0 4
0 4 5 4 2 3 2 4 5 0
2 4 2 4 5 3 3 2 3 4 
