2 3 2 4 0 2 3 5 2
5 4 5 2 0 5 4 2 3
4 0 3 0 1 0 3 0 2
2 2 5 3 0 2 5 3 4
3 5 4 1 0 1 3 2 5