1 3 1 4 0 1 3 1 4
2 1 5 1 0 5 1 2 1
3 0 3 0 3 0 3 0 5
1 2 4 1 0 1 5 3 1
1 5 4 1 0 1 3 2 1