2 3 4 5 3 2 5 3 4 5 3 2
3 5 3 2 1 2 1 2 1 3 5 3
4 3 2 0 1 0 0 1 0 2 3 4
1 1 3 0 3 3 2 5 0 2 1 1
4 0 3 0 1 5 4 1 0 1 0 5
2 3 4 5 3 2 2 3 5 4 3 2
3 5 3 2 1 2 1 2 1 3 5 3