2 3 4 5 3 2 5 3 4 5 3 2
3 5 3 2 1 2 1 2 1 3 5 3
4 3 2 0 1 0 0 1 0 2 3 4
1 1 0 0 3 3 0 0 5 2 1 1
0 0 3 0 0 5 4 1 0 1 0 0
2 3 4 5 3 2 2 3 5 4 3 2
3 5 3 2 1 2 1 2 1 3 5 3